##########
#S       #
######## #
#X       #
##########