####################
#        X#S       #
#P############## ###
#           #      #
########## ## ####P#
#              A#A #
####################