####################
#        X#S       #
#P############## ###
#           #      #
########## ## ####P#
#              APA #
####################