####################################
#              X#                  #
# ############################## ###
#                       #         S#
###P################# ### ##########
#   #                 #            #
# ######## ############ ########## #
# #        #               #       #
# # ######################## ##### #
# #                              # #
# ################################ #
#              A#                  #
####################################