###########
#    S    #
# ### ###P#
# # #P# # #
#A# #A# #X#
### ### ###