#########
#X #    #
#  #    #
##P#    #
#   S   #
#       #
#       #
#      A#
#########