###########
#    S   P#
# ### ###A#
# # #P# #P#
#A# #A# #X#
### ### ###