#########
#S  #  P#
#    #  #
##      #
#      X#
#########