    #######
    #AAAAA#
    ### ###
      #P#  
####### ###
#    S    #
# ### ###P#
# # #P# #P#
# # # # # #
#A# #A# #X#
### ### ###