#########
#AA    S#
# ##### #
# PPXPP #
#########