#########
#   P A #
# ##### #
#A#   #P#
#S#   #X#
###   ###