#############
#    S     P#
# ### ###P# #
# # #P# #P#A#
# # # # # # #
#A# #A# #X P#
### ### #####