#############
#    S     P#   ###
# ### ###P# #####A#
# # #P# #P#A  P   #
# # # # # # #####A#
#A# #A# #XPP#   ###
### ### #####