###########
#    S    #
# ### ###P#
# # #P# # #
#A# # # #X#
### ### ###