###############
#    S     P A#
# ### ###P###P#
# # #P# #P# # #
#A# #A# #X# #X#
### ### ### ###