#########
#   S   #
# #####P#
# #   # #
#A#   #X#
###   ###